Year,Month,Fatal Collisions,Non-Fatal Injury Collisions,Property Damage Collisions,Total Collsions
2007,January,32,1656,12718,14406
2007,February,18,1514,12973,14505
2007,March,26,1298,10694,12018
2007,April,25,1177,9124,10326
2007,May,30,1414,9245,10689
2007,June,40,1565,10350,11955
2007,July,50,1543,10201,11794
2007,August,37,1486,9575,11098
2007,September,35,1485,10073,11593
2007,October,36,1595,10882,12513
2007,November,39,1476,13964,15479
2007,December,34,1644,15573,17251
