Year,Month,Fatal Collisions,Non-Fatal Injury Collisions,Property Damage Collisions,Total Collsions
2009,January,18,1308,15169,16495
2009,February,16,1072,11582,12670
2009,March,19,1223,13829,15071
2009,April,23,914,8855,9792
2009,May,27,1062,9169,10258
2009,June,28,1216,9892,11136
2009,July,40,1148,9819,11007
2009,August,32,1271,9324,10627
2009,September,32,1318,9897,11247
2009,October,25,1243,12613,13881
2009,November,24,1152,13294,14470
2009,December,18,1316,18855,20189
