Year,Month,Fatal Collisions,Non-Fatal Injury Collisions,Property Damage Collisions,Total Collsions
2000,January,21,1597,9299,10917
2000,February,16,1374,7253,8643
2000,March,21,1318,6653,7992
2000,April,19,1227,5514,6760
2000,May,18,1441,5448,6907
2000,June,26,1583,6287,7896
2000,July,39,1532,6314,7885
2000,August,27,1530,6037,7594
2000,September,32,1659,6351,8042
2000,October,28,1459,6743,8230
2000,November,36,1645,8685,10366
2000,December,29,1876,11119,13024
