Year,Month,Fatal Collisions,Non-Fatal Injury Collisions,Property Damage Collisions,Total Collsions
2006,January,34,1480,10094,11608
2006,February,34,1265,9404,10703
2006,March,26,1463,10172,11661
2006,April,31,1250,7291,8572
2006,May,34,1458,8439,9931
2006,June,28,1645,9696,11369
2006,July,33,1684,8849,10566
2006,August,40,1654,8530,10224
2006,September,40,1706,9258,11004
2006,October,37,1837,11487,13361
2006,November,30,1795,16810,18635
2006,December,37,1591,13093,14721
