Year,Month,Fatal Collisions,Non-Fatal Injury Collisions,Property Damage Collisions,Total Collsions
1998,January,18,1450,9615,11083
1998,February,21,987,5464,6472
1998,March,24,1309,7280,8613
1998,April,25,1131,4554,5710
1998,May,35,1433,5566,7034
1998,June,26,1474,6219,7719
1998,July,30,1571,6393,7994
1998,August,37,1465,5760,7262
1998,September,37,1522,6114,7673
1998,October,34,1492,6627,8153
1998,November,37,1493,8521,10051
1998,December,34,1645,8941,10620
