Year,Month,Fatal Collisions,Non-Fatal Injury Collisions,Property Damage Collisions,Total Collsions
2005,January,28,1703,11739,13470
2005,February,25,1146,8008,9179
2005,March,19,1329,8274,9622
2005,April,23,1246,6541,7810
2005,May,26,1445,7167,8638
2005,June,34,1473,8477,9984
2005,July,45,1510,7990,9545
2005,August,42,1539,7735,9316
2005,September,39,1552,7885,9476
2005,October,35,1506,8671,10212
2005,November,34,1599,10988,12621
2005,December,42,1675,12369,14086
