Year,Month,Fatal Collisions,Non-Fatal Injury Collisions,Property Damage Collisions,Total Collsions
2013,January,22,1273,12300,13595
2013,February,23,994,8877,9894
2013,March,13,1067,11121,12201
2013,April,17,842,8747,9606
2013,May,40,1125,9027,10192
2013,June,33,1134,9170,10337
2013,July,35,1217,9233,10485
2013,August,28,1268,8830,10126
2013,September,48,1286,9483,10817
2013,October,29,1269,10652,11950
2013,November,23,1333,14123,15479
2013,December,20,1263,15656,16939
