Year,Month,Fatal Collisions,Non-Fatal Injury Collisions,Property Damage Collisions,Total Collsions
2003,January,21,1879,10239,12139
2003,February,19,1537,8439,9995
2003,March,14,1658,9008,10680
2003,April,18,1262,6500,7780
2003,May,30,1513,6303,7846
2003,June,26,1534,6970,8530
2003,July,45,1581,7000,8626
2003,August,34,1543,6163,7740
2003,September,29,1497,6420,7946
2003,October,30,1529,7933,9492
2003,November,23,1575,10642,12240
2003,December,32,1337,8725,10094
