Year,Month,Fatal Collisions,Non-Fatal Injury Collisions,Property Damage Collisions,Total Collsions
2008,January,27,1514,14672,16213
2008,February,19,1346,13257,14622
2008,March,23,1127,10169,11319
2008,April,29,1174,10646,11849
2008,May,29,1227,9324,10580
2008,June,25,1339,10359,11723
2008,July,38,1374,10367,11779
2008,August,41,1341,9676,11058
2008,September,41,1411,10135,11587
2008,October,41,1374,11127,12542
2008,November,34,1350,12528,13912
2008,December,28,1573,18945,20546
