Year,Month,Fatal Collisions,Non-Fatal Injury Collisions,Property Damage Collisions,Total Collsions
2014,January,21,1195,12901,14117
2014,February,23,1020,11206,12249
2014,March,23,1102,11522,12647
2014,April,18,895,8696,9609
2014,May,31,1116,8997,10144
2014,June,29,1208,9453,10690
2014,July,41,1291,9528,10860
2014,August,24,1167,9064,10255
2014,September,30,1339,10031,11400
2014,October,37,1381,10466,11884
2014,November,24,1346,15702,17072
2014,December,27,1183,12597,13807
