Year,Month,Fatal Collisions,Non-Fatal Injury Collisions,Property Damage Collisions,Total Collsions
2004,January,29,1815,11668,13512
2004,February,21,1350,7540,8911
2004,March,13,1300,6851,8164
2004,April,26,1147,5967,7140
2004,May,22,1247,5761,7030
2004,June,28,1492,6867,8387
2004,July,44,1452,6967,8463
2004,August,34,1401,6247,7682
2004,September,33,1488,6679,8200
2004,October,33,1577,9347,10957
2004,November,28,1341,9111,10480
2004,December,28,1637,11737,13402
