Year,Month,Fatal Collisions,Non-Fatal Injury Collisions,Property Damage Collisions,Total Collsions
1999,January,20,1481,8855,10356
1999,February,14,1199,5743,6956
1999,March,24,1346,5998,7368
1999,April,16,1148,5010,6174
1999,May,32,1388,5429,6849
1999,June,31,1473,5988,7492
1999,July,24,1566,6141,7731
1999,August,32,1530,5878,7440
1999,September,25,1620,6090,7735
1999,October,31,1566,6644,8241
1999,November,27,1575,7790,9392
1999,December,29,1501,7800,9330
