Year,Month,Fatal Collisions,Non-Fatal Injury Collisions,Property Damage Collisions,Total Collsions
2010,January,21,1128,13620,14769
2010,February,16,896,10177,11089
2010,March,19,912,9761,10692
2010,April,14,996,9022,10032
2010,May,27,1068,9810,10905
2010,June,27,1188,10774,11989
2010,July,37,1141,10211,11389
2010,August,36,1114,9743,10893
2010,September,28,1210,10588,11826
2010,October,30,1321,11507,12858
2010,November,32,1269,16214,17515
2010,December,20,1300,15656,16976
