Year,Month,Fatal Collisions,Non-Fatal Injury Collisions,Property Damage Collisions,Total Collsions
2011,January,22,1386,15375,16783
2011,February,16,1085,12372,13473
2011,March,13,1204,11891,13108
2011,April,22,846,8487,9355
2011,May,15,991,7969,8975
2011,June,23,1136,9007,10166
2011,July,23,1234,9069,10326
2011,August,24,1261,8640,9925
2011,September,41,1244,8869,10154
2011,October,31,1188,9647,10866
2011,November,30,1183,12357,13570
2011,December,25,1143,11021,12189
