Year,Month,Fatal Collisions,Non-Fatal Injury Collisions,Property Damage Collisions,Total Collsions
2001,January,31,1333,7117,8481
2001,February,19,1416,7546,8981
2001,March,23,1430,6783,8236
2001,April,26,1324,5750,7100
2001,May,24,1569,5928,7521
2001,June,36,1638,6666,8340
2001,July,28,1639,6589,8256
2001,August,39,1754,6818,8611
2001,September,36,1608,6677,8321
2001,October,32,1793,8060,9885
2001,November,27,1654,9743,11424
2001,December,20,1836,10145,12001
