Year,Month,Fatal Collisions,Non-Fatal Injury Collisions,Property Damage Collisions,Total Collsions
2002,January,27,1882,9894,11803
2002,February,16,1490,7466,8972
2002,March,18,1815,10030,11863
2002,April,19,1367,6735,8121
2002,May,29,1452,6353,7834
2002,June,36,1640,6958,8634
2002,July,28,1731,7165,8924
2002,August,34,1648,6676,8358
2002,September,26,1712,6939,8677
2002,October,27,1804,8956,10787
2002,November,25,1669,9172,10866
2002,December,37,1939,9219,11195
