Year,Month,Fatal Collisions,Non-Fatal Injury Collisions,Property Damage Collisions,Total Collsions
2012,January,32,1071,11410,12513
2012,February,14,991,9615,10620
2012,March,30,1038,9683,10751
2012,April,14,882,7829,8725
2012,May,22,1042,8376,9440
2012,June,35,1174,9207,10416
2012,July,32,1248,8878,10158
2012,August,33,1256,8653,9942
2012,September,35,1267,9078,10380
2012,October,25,1289,11262,12576
2012,November,19,1249,14372,15640
2012,December,16,1308,13889,15213
